F 40,113,43
SO   textures/greystone.xpm
NO    textures/eagle.xpm
EA textures/red.xpm   

WE textures/purplestone.xpm     

C 89,198,227

 111111
100001111 11111   111
10N0000001   1011  101
111111111  1111    11